Crawl	KEYWORD1
crl	KEYWORD1
CrlRobot	KEYWORD1
FirtstOrderFilter	KEYWORD1
LaggedDerivative	KEYWORD1
Integral	KEYWORD1
init	KEYWORD2
setDt	KEYWORD2
setT	KEYWORD2
calculate	KEYWORD2
getOutput	KEYWORD2
setLimit
getThetaX	KEYWORD2
getThetaY	KEYWORD2
getThetaZ	KEYWORD2
getAccX	KEYWORD2
getAccY	KEYWORD2
getAccZ	KEYWORD2
getThetaDotX	KEYWORD2
getThetaDotY	KEYWORD2
getThetaDotZ	KEYWORD2
getEncoderLeft	KEYWORD2
getEncoderRight KEYWORD2
getOdometryLeft KEYWORD2
getOdometryRight KEYWORD2
resetEncoderLeft	KEYWORD2
resetEncoderRight	KEYWORD2
setMotorLeft	KEYWORD2
setMotorRight	KEYWORD2
realtimeLoop	KEYWORD2
updateState	KEYWORD2
getHeadVelocity	KEYWORD2
